MODE 3
SIZE 9/11
LIMIT 0/33
COLOR LIMIT 5
STARS 5000/8600/15000
COLLECT COUNT 0/0
COLLECT ITEMS 1/2
10 10 10 10 00 10 10 10 10
10 20 20 10 00 10 20 20 10
10 20 20 10 10 10 20 20 10
00 00 10 10 10 10 10 00 00
10 10 10 10 10 10 10 10 10
10 10 10 10 10 10 10 10 10
14 14 14 14 14 14 14 14 14
50 50 50 50 14 50 50 50 50
10 10 10 50 14 50 10 10 10
10 10 10 50 14 50 10 10 10
23 17 10 50 14 50 10 17 23